Hello Raymond, you have to escape zombies and  find a way back to the survivors camp.

ZombieAttack
An Interactive Fiction by Raymond Packa
Release 1 / Serial number 170207 / Inform 7 build 6M62 (I6/v6.33 lib 6/12N) SD

Hut
You are in an abandoned hut right now. The hut is dark and cold. North from the hut, there is a dark forest and  West from the hut there is a long road.

You can see a wooden door, Torch, Gun, Bloody message and Dresser (closed) here.

>take sabre
Taken.

>i
You are carrying:
  Sabre

* * *

Hello Raymond, you have to escape zombies and  find a way back to the survivors camp.

ZombieAttack
An Interactive Fiction by Raymond Packa
Release 1 / Serial number 170207 / Inform 7 build 6M62 (I6/v6.33 lib 6/12N) SD

Hut
You are in an abandoned hut right now. The hut is dark and cold. North from the hut, there is a dark forest and  West from the hut there is a long road.

You can see a wooden door, Torch, Gun, Bloody message and Dresser (closed) here.

>move
What do you want to move?

>move Torch
Nothing obvious happens.

>take torch
Taken.

>take gun
Taken.

>i
You are carrying:
  Gun
  Torch

* * *

Hello Raymond, you have to escape zombies and  find a way back to the survivors camp.

ZombieAttack
An Interactive Fiction by Raymond Packa
Release 1 / Serial number 170207 / Inform 7 build 6M62 (I6/v6.33 lib 6/12N) SD

Hut
You are in an abandoned hut right now. The hut is dark and cold. North from the hut, there is a dark forest and  West from the hut there is a long road.

You can see a wooden door, Torch, Gun, Bloody message and Dresser (closed) here.

>take torch
Taken.

>take gun
Thie gun can help you killing zombies

>i
You are carrying:
  Gun
  Torch

* * *

>take gun
Thie gun can help you killing zombies

>go north
Forest

* * *

Hello Raymond, you have to escape zombies and  find a way back to the survivors camp.

ZombieAttack
An Interactive Fiction by Raymond Packa
Release 1 / Serial number 170207 / Inform 7 build 6M62 (I6/v6.33 lib 6/12N) SD

Hut
You are in an abandoned hut right now. The hut is dark and cold. North from the hut, there is a dark forest and  West from the hut there is a long road.

You can see a wooden door, Torch, Gun, Bloody message and Dresser (closed) here.

>go south
You can't go that way.

>go west
You can't go that way.

>go north
Forest
You are now in the dark forest.

>i
You are carrying nothing.

* * *

Hello Raymond, you have to escape zombies and  find a way back to the survivors camp.

ZombieAttack
An Interactive Fiction by Raymond Packa
Release 1 / Serial number 170207 / Inform 7 build 6M62 (I6/v6.33 lib 6/12N) SD

Hut
You are in an abandoned hut right now. The hut is dark and cold. North from the hut, there is a dark forest and  West from the hut there is a long road.

You can see a wooden door, Torch, Gun, Bloody message and Dresser (closed) here.

>go north
Forest
You are now in the dark forest.

* * *

Hello Raymond, you have to escape zombies and  find a way back to the survivors camp.

ZombieAttack
An Interactive Fiction by Raymond Packa
Release 1 / Serial number 170207 / Inform 7 build 6M62 (I6/v6.33 lib 6/12N) SD

Hut
You are in an abandoned hut right now. The hut is dark and cold. North from the hut, there is a dark forest and  West from the hut there is a long road.

You can see a wooden door, Torch, Gun, Bloody message and Dresser (closed) here.

>take gun
Taken. This gun can help you killing zombies.

>take torch
Taken.

>take Gold key
This key can help you unlock the hut door.

>go door
(first opening the wooden door)

Forest
You are now in the dark forest.

You can see a wooden door here.

* * *

>take gun
Taken. This gun can help you killing zombies.

>open dresser
You open Dresser, revealing Gold key.

>take gold key
Taken. Maybe this key could help you unlock the wooden door.

>unlock door
What do you want to unlock the wooden door with?

>gold key
You unlock the wooden door.

>go door
(first opening the wooden door)

Forest
You are now in the dark forest.  On your right (E) you can see an abandonned car, on your left (W) a dark road and an Abandonned bag just next to the car. You can hear some  stranges  screams from the Dark road.

You can see a wooden door, Abandonned bag (closed) and Mustang here.

>go w
Dark road
You are now West from the forest. You were walking quietly on the road when suddenly, a zombie attacked you. 

You can see Dead body (closed) here.

Surprised by the zombie attack, you try to find a way to kill him.  Happily, You remember that you have a gun. You take the gun and shoot the zombie. Now the zombie is dead.

>open dead body
You open Dead body, revealing Car key.

>take car key
Taken.

>go e
Forest
You are now in the dark forest.  On your right (E) you can see an abandonned car, on your left (W) a dark road and an Abandonned bag just next to the car. You can hear some  stranges  screams from the Dark road.

You can see a wooden door, Abandonned bag (closed) and Car here.

>unlock Car
What do you want to unlock Car key with?

>Car
I didn't understand that sentence.

>car key
That's not a verb I recognise.

>go e
(first opening Car)
It seems to be locked.

>open car
(Car key)
It isn't something you can open.

* * *

>go door
(first opening the wooden door)

Forest
You are now in the dark forest.  On your right (E) you can see an abandonned car, on your left (W) a dark road and an Abandonned bag just next to the car. You can hear some  stranges  screams from the Dark road.

You can see a wooden door, Abandonned bag (closed) and Mustang here.

>go mustang
(first opening Mustang)
It seems to be locked.

>go w
Dark road
You are now West from the forest. You were walking quietly on the road when suddenly, a zombie attacked you. 

You can see Dead body (closed) here.

Surprised by the zombie attack, you try to find a way to kill him.  Happily, You remember that you have a gun. You take the gun and shoot the zombie. Now the zombie is dead.

* * *

>take car key
Taken.

>go e
Forest
You are now in the dark forest.  On your right (E) you can see an abandonned car, on your left (W) a dark road and an Abandonned bag just next to the car. You can hear some  stranges  screams from the Dark road.

You can see a wooden door, Abandonned bag (closed) and Mustang here.

>open mustang
It seems to be locked.

>unlock mustang
What do you want to unlock Mustang with?

>car key
You unlock Mustang.

>open mustang
You open Mustang.

Happily the key starts the car ! You found a safe way to go back to the survivors camp, CONGRATULATIONS !!!

    *** The End ***

Would you like to RESTART, RESTORE a saved game, QUIT or UNDO the last command?

* * *

Hello Raymond, you have to escape zombies and  find a way back to the survivors camp.

ZombieAttack
An Interactive Fiction by Raymond Packa
Release 1 / Serial number 170207 / Inform 7 build 6M62 (I6/v6.33 lib 6/12N) SD

Hut
You are in an abandoned hut right now. The hut is dark and cold. North from the hut, there is a dark forest and  West from the hut there is a long road.

You can see a wooden door, Torch, Gun, Bloody message and Dresser (closed) here.

>go door
(first opening the wooden door)
It seems to be locked.

>go south
You can't go that way.

>go north
(first opening the wooden door)
It seems to be locked.

* * *

>go door
(first opening the wooden door)
It seems to be locked.

>take gun
Taken. This gun can help you killing zombies.

* * *

>take torch
Taken.

>take Gold key
Taken. This key can help you unlock the hut door.

>go door
(first opening the wooden door)
It seems to be locked.

>i
You are carrying:
  Gold key
  Torch
  Gun

>take golde key
You can't see any such thing.

>take gold key
You already have that.

>unlock door
What do you want to unlock the wooden door with?

* * *

>gold key
You unlock the wooden door.

>go door
(first opening the wooden door)

Forest
You are now in the dark forest.

You can see a wooden door here.

* * *

>go door
(first opening the wooden door)
It seems to be locked.

>open dresser
You open Dresser, revealing Gold key.

* * *

>take gold key
Taken. Maybe this key could help you unlock the wooden door.

>unlock door
(with Gold key)
You unlock the wooden door.

>go door
(first opening the wooden door)

Forest
You are now in the dark forest.  On your left you can see an abandonned car, on your right a dark road and an Abandonned bag just next to the car. You can hear some  stranges  screams from the Dark road.

You can see a wooden door, Abandonned bag (closed) and Car here.

>go wooden door
Hut
You are in an abandoned hut right now. The hut is dark and cold. North from the hut, there is a dark forest and  West from the hut there is a long road.

You can see a wooden door, Torch, Gun, Bloody message and Dresser (empty) here.

>take gun
Taken. This gun can help you killing zombies.

>go door
Forest
You are now in the dark forest.  On your left you can see an abandonned car, on your right a dark road and an Abandonned bag just next to the car. You can hear some  stranges  screams from the Dark road.

You can see a wooden door, Abandonned bag (closed) and Car here.

>go west
Dark road
You were  walking quietly on the road when suddenly, a zombie attacked you. 

You can see Dead body (closed) here.

Surprised by the zombie attack, you try to find a way to kill him.  Happily, You remember that you have a gun. You take the gun and shoot the zombie. Now the zombie is dead.

>examine dead body
You see nothing special about Dead body.

>open dead body
You open Dead body, revealing Car key.

* * *

>take car key
Taken.

>goforest
That's not a verb I recognise.

>go forest
You can't see any such thing.

>go back
You can't see any such thing.

>go e
Forest
You are now in the dark forest.  On your left you can see an abandonned car, on your right a dark road and an Abandonned bag just next to the car. You can hear some  stranges  screams from the Dark road.

You can see a wooden door, Abandonned bag (closed) and Car here.

* * *

Hello Raymond, you have to escape zombies and  find a way back to the survivors camp.

ZombieAttack
An Interactive Fiction by Raymond Packa
Release 1 / Serial number 170207 / Inform 7 build 6M62 (I6/v6.33 lib 6/12N) SD

Hut
You are in an abandoned hut right now. The hut is dark and cold. North from the hut, there is a dark forest and  West from the hut there is a long road.

You can see a wooden door, Torch, Gun, Bloody message and Dresser (closed) here.

>open dresser
You open Dresser, revealing Gold key.

* * *

>unlock door
(with Gold key)
You unlock the wooden door.

>go door
(first opening the wooden door)

Forest
You are now in the dark forest. 

You can see a wooden door, Car and Zombie here.

>use gun
That's not a verb I recognise.

>attack zombie
Violence isn't the answer to this one.

>kick zombie
That's not a verb I recognise.

* * *

>take gold key
Taken. Maybe this key could help you unlock the wooden door.

>unlock wooden door
(with Gold key)
You unlock the wooden door.

>go door
(first opening the wooden door)

Forest
You are now in the dark forest.  On your left you can see an abandonned car, on your right a dark road and an Abandonned bag just next to the car. You can hear some  stranges  screams from the Dark road.

You can see a wooden door, Abandonned bag (closed) and Car here.

>go car
(first opening Car)
It seems to be locked.

>open Abandonned bag
You open Abandonned bag.

>examine aBANDONNED BAG
Abandonned bag is empty.

>close abandonned bag
You close Abandonned bag.

>i
You are carrying:
  Gold key

>go west
Dark road
You were  walking quietly on the road when suddenly, a zombie attacked you. 

You can see Dead body (in which is Car key) here.

Surprised by the zombie attack, you tried to find a way to kill him but abortively. The zombie bit you and you die lonely on the Dark Forest. END OF THE GAME :(

    *** The End ***

Would you like to RESTART, RESTORE a saved game, QUIT or UNDO the last command?

>restart
Hello Raymond, you have to escape zombies and  find a way back to the survivor camp.

ZombieAttack
An Interactive Fiction by Raymond Packa
Release 1 / Serial number 170207 / Inform 7 build 6M62 (I6/v6.33 lib 6/12N) SD

Hut
You are in an abandoned hut right now. The hut is dark and cold. North from the hut, there is a dark forest and  West from the hut there is a long road.

You can see a wooden door, Torch, Gun, Bloody message and Dresser (closed) here.

>open dresser
You open Dresser, revealing Gold key.

* * *

>go door
Forest
You are now in the dark forest.  On your left you can see an abandonned car, on your right a dark road and an Abandonned bag just next to the car. You can hear some  stranges  screams from the Dark road.

You can see a wooden door, Abandonned bag (closed) and Car here.

>go Dark road
You can't see any such thing.

>go dark road
You can't see any such thing.

>go west
Dark road
You were  walking quietly on the road when suddenly, a zombie attacked you. 

You can see Dead body (in which is Car key) here.

Surprised by the zombie attack, you try to find a way to kill him.  Happily, You remember that you have a gun. You take the gun and shoot the zombie. Now the zombie is dead.

* * *

Hello Raymond, you have to escape zombies and  find a way back to the survivors camp.

ZombieAttack
An Interactive Fiction by Raymond Packa
Release 1 / Serial number 170207 / Inform 7 build 6M62 (I6/v6.33 lib 6/12N) SD

Hut
You are in an abandoned hut right now. The hut is dark and cold. North from the hut, there is a dark forest and  West from the hut there is a long road.

You can see a wooden door, Torch, Gun, Bloody message and Dresser (closed) here.

>open door
It seems to be locked.

>go door
(first opening the wooden door)
It seems to be locked.